abate		become less in amount or intensity
chicanery		the use of tricks to deceive someone
disseminate		cause to become widely known
gainsay		take exception to
latent		potentially existing but not presently evident or realized
aberrant		markedly different from an accepted norm
coagulate		change from a liquid to a thickened or solid state
dissolution		separation into component parts
garrulous		full of trivial conversation
laud		praise, glorify, or honor
abeyance		temporary cessation or suspension
coda		the closing section of a musical composition
dissonance		disagreeable sounds
goad		stab or urge on as if with a pointed stick
lethargic		deficient in alertness or activity
abscond		run away
cogent		powerfully persuasive
distend		cause to expand as it by internal pressure
gouge		an impression in a surface, as made by a blow
levee		an embankment built to prevent a river from overflowing
abstemious		marked by temperance in indulgence
commensurate		corresponding in size or degree or extent
distill		undergo condensation
grandiloquent		lofty in style
levity		a manner lacking seriousness
admonish		scold or reprimand; take to task
compendium		a publication containing a variety of works
diverge		<a class="word dynamictext" href="/dictionary/diverge">diverge</a>	
gregarious		move or draw apart
log		temperamentally seeking and enjoying the company of others
adulterate		a segment of the trunk of a tree when stripped of branches
complaisant		make impure by adding a foreign or inferior substance
divest		showing a cheerful willingness to do favors for others
guileless		<a class="word dynamictext" href="/dictionary/divest">divest</a>	
loquacious		take away possessions from someone
aesthetic		free of deceit
compliant		full of trivial conversation
document		characterized by an appreciation of beauty or good taste
gullible		disposed to act in accordance with someone's wishes
lucid		a representation of a person's thinking with symbolic marks
aggregate		naive and easily deceived or tricked
conciliatory		transparently clear; easily understandable
dogmatic		a sum total of many heterogeneous things taken together
harangue		making or willing to make concessions
luminous		pertaining to a code of beliefs accepted as authoritative
alacrity		a loud bombastic declamation expressed with strong emotion
condone		softly bright or radiant
dormant		liveliness and eagerness
homogeneous		excuse, overlook, or make allowances for
magnanimity		inactive but capable of becoming active
alleviate		all of the same or similar kind or nature
confound		liberality in bestowing gifts
dupe		provide physical relief, as from pain
hyperbole		be confusing or perplexing to
malingerer		fool or hoax
amalgamate		extravagant exaggeration
connoisseur		someone shirking duty by feigning illness or incapacity
ebullient		to bring or combine together or with something else
iconoclastic		an expert able to appreciate a field
malleable		joyously unrestrained
ambiguous		characterized by attack on established beliefs
contention		capable of being shaped or bent
eclectic		having more than one possible meaning
idolatry		the act of competing as for profit or a prize
maverick		selecting what seems best of various styles or ideas
ambivalence		the worship of idols or images that are not God
contentious		someone who exhibits independence in thought and action
efficacy		mixed feelings or emotions
immutable		showing an inclination to disagree
mendacious		capacity or power to produce a desired effect
ameliorate		not subject or susceptible to change or variation
contrite		given to lying
effrontery		to make better
impair		feeling or expressing pain or sorrow for sins or offenses
metamorphosis		audacious behavior that you have no right to
anachronism		make worse or less effective
conundrum		striking change in appearance or character or circumstances
elegy		something located at a time when it could not have existed
impassive		a difficult problem
meticulous		a mournful poem; a lament for the dead
analogous		having or revealing little emotion or sensibility
converge		marked by precise accordance with details
elicit		similar or equivalent in some respects
impede		be adjacent or come together
misanthrope		call forth, as an emotion, feeling, or response
anarchy		be a hindrance or obstacle to
convoluted		someone who dislikes people in general
embellish		a state of lawlessness and disorder
impermeable		rolled longitudinally upon itself
mitigate		make more attractive, as by adding ornament or color
anomalous		preventing especially liquids to pass or diffuse through
craven		lessen or to try to lessen the seriousness or extent of
empirical		deviating from the general or common order or type
imperturbable		lacking even the rudiments of courage; abjectly fearful
mollify		derived from experiment and observation rather than theory
antipathy		marked by extreme calm and composure
daunt		cause to be more favorably inclined
emulate		a feeling of intense dislike
impervious		cause to lose courage
morose		strive to equal or match, especially by imitating
apathy		not admitting of passage or capable of being affected
decorum		showing a brooding ill humor
endemic		an absence of emotion or enthusiasm
implacable		propriety in manners and conduct
mundane		native to or confined to a certain region
appease		incapable of being appeased or pacified
default		found in the ordinary course of events
enervate		make peace with
implicit		an option that is selected automatically
negate		weaken mentally or morally
apprise		suggested though not directly expressed
deference		make ineffective by counterbalancing the effect of
engender		inform somebody of something
implode		courteous regard for people's feelings
neophyte		make children
approbation		burst inward
delineate		any new participant in some activity
enhance		official approval
inadvertently		represented accurately or precisely
obdurate		increase
appropriate		without knowledge or intention
denigrate		stubbornly persistent in wrongdoing
ephemeral		suitable for a particular person, place, or situation
inchoate		charge falsely or with malicious intent
obsequious		anything short-lived, as an insect that lives only for a day
arduous		only partly in existence; imperfectly formed
deride		attempting to win favor from influential people by flattery
equanimity		characterized by effort to the point of exhaustion
incongruity		treat or speak of with contempt
obviate		steadiness of mind under stress
artless		the quality of disagreeing
derivative		do away with
equivocate		simple and natural; without cunning or deceit
inconsequential		a compound obtained from another compound
occlude		be deliberately ambiguous or unclear
ascetic		lacking worth or importance
desiccate		block passage through
erudite		someone who practices self denial as a spiritual discipline
incorporate		lacking vitality or spirit; lifeless
officious		having or showing profound knowledge
assiduous		make into a whole or make part of a whole
desultory		intrusive in a meddling or offensive manner
esoteric		marked by care and persistent effort
indeterminate		marked by lack of definite plan or regularity or purpose
onerous		understandable only by an enlightened inner circle
assuage		not fixed or known in advance
deterrent		not easily borne; wearing
eulogy		provide physical relief, as from pain
indigence		something immaterial that interferes with action or progress
opprobrium		a formal expression of praise for someone who has died
attenuate		a state of extreme poverty or destitution
diatribe		a state of extreme dishonor
euphemism		become weaker, in strength, value, or magnitude
indolent		thunderous verbal attack
oscillate		an inoffensive expression substituted for an offensive one
audacious		disinclined to work or exertion
dichotomy		move or swing from side to side regularly
exacerbate		disposed to venture or take risks
inert		being twofold
ostentatious		make worse
austere		unable to move or resist motion
diffidence		intended to attract notice and impress others
exculpate		of a stern or strict bearing or demeanor
pate		lack of self-assurance
ingenuous		pronounce not guilty of criminal charges
paragon		liver or meat or fowl finely minced or ground and variously seasoned
autonomous		lacking in sophistication or worldliness
diffuse		a perfect embodiment of a concept
exigency		existing as an independent entity
inherent		spread out; not concentrated in one place
partisan		a pressing or urgent situation
aver		existing as an essential constituent or characteristic
digression		a fervent and even militant proponent of something
extrapolation		to declare or affirm solemnly and formally as true
innocuous		a turning aside
pathological		an inference about the future based on known facts
banal		not injurious to physical or mental health
dirge		relating to the study of diseases
facetious		repeated too often; overfamiliar through overuse
insensible		a song or hymn of mourning as a memorial to a dead person
paucity		cleverly amusing in tone
belie		barely able to be perceived
disabuse		an insufficient quantity or number
facilitate		be in contradiction with
insinuate		free somebody from an erroneous belief
pedantic		make easier
beneficent		suggest in an indirect or covert way; give to understand
discerning		marked by a narrow focus on or display of learning
fallacious		doing or producing good
insipid		having or revealing keen insight and good judgment
penchant		containing or based on incorrect reasoning
bolster		lacking interest or significance or impact
discordant		a strong liking
fatuous		support and strengthen
insularity		not in agreement or harmony
penury		devoid of intelligence
bombastic		the state of being isolated or detached
discredit		a state of extreme poverty or destitution
fawning		ostentatiously lofty in style
intractable		the state of being held in low esteem
perennial		attempting to win favor by flattery
boorish		difficult to manage or mold
discrepancy		lasting three seasons or more
felicitous		ill-mannered and coarse in behavior or appearance
intransigence		a difference between conflicting facts or claims or opinions
perfidious		exhibiting an agreeably appropriate manner or style
burgeon		stubborn refusal to compromise or change
discrete		tending to betray
fervor		grow and flourish
inundate		constituting a separate entity or part
perfunctory		feelings of great warmth and intensity
burnish		fill or cover completely, usually with water
disingenuous		hasty and without attention to detail; not thorough
flag		polish and make shiny
inured		not straightforward or candid
permeable		a rectangular piece of cloth of distinctive design
buttress		made tough by habitual exposure
disinterested		allowing fluids or gases to pass or diffuse through
fledgling		a support usually of stone or brick
invective		unaffected by concern for one's own welfare
pervasive		young bird that has just fledged or become capable of flying
cacophonous		abusive language used to express blame or censure
disjointed		spreading or spread throughout
flout		having an unpleasant sound
irascible		taken apart at the points of connection
phlegmatic		treat with contemptuous disregard
capricious		quickly aroused to anger
dismiss		showing little emotion
foment		determined by chance or impulse rather than by necessity
irresolute		stop associating with
piety		try to stir up
castigation		uncertain how to act or proceed
disparage		righteousness by virtue of being pious
forestall		verbal punishment
itinerary		express a negative opinion of
placate		keep from happening or arising; make impossible
catalyst		an established line of travel or access
disparate		cause to be more favorably inclined
frugality		substance that initiates or accelerates a chemical reaction
laconic		fundamentally different or distinct in quality or kind
plasticity		prudence in avoiding waste
caustic		brief and to the point
dissemble		the property of being physically malleable
futile		capable of destroying or eating away by chemical action
lassitude		behave unnaturally or affectedly
platitude		producing no result or effect
plethora		a feeling of lack of interest or energy
propitiate		a trite or obvious remark
rescind		extreme excess
sporadic		make peace with
tractable		cancel officially
plummet		recurring in scattered or unpredictable instances
propriety		easily managed
resolution		drop sharply
stigma		correct behavior
transgression		a decision to do something or to behave in a certain manner
porous		a symbol of disgrace or infamy
proscribe		the violation of a law or a duty or moral principle
resolve		full of vessels or holes
stint		command against
truculence		find a solution or answer
pragmatic		supply sparingly and with restricted quantities
pungent		obstreperous and defiant aggressiveness
reticent		concerned with practical matters
stipulate		strong and sharp
vacillate		reluctant to draw attention to yourself
preamble		make an express demand or provision in an agreement
qualified		be undecided about something
reverent		a preliminary introduction to a statute or constitution
stolid		meeting the proper standards and requirements for a task
venerate		feeling or showing profound respect or veneration
precarious		having or revealing little emotion or sensibility
quibble		regard with feelings of respect and reverence
sage		not secure; beset with difficulties
striate		evade the truth of a point by raising irrelevant objections
veracious		a mentor in spiritual and philosophical topics
precipitate		marked with stripes
quiescent		habitually speaking the truth
salubrious		bring about abruptly
strut		being quiet or still or inactive
verbose		promoting health
precursor		to walk with a lofty proud gait
rarefied		using or containing too many words
sanction		something indicating the approach of something or someone
subpoena		of high moral or intellectual value
viable		official permission or approval
presumptuous		a writ issued to compel the attendance of a witness
recalcitrant		capable of life or normal growth and development
satiate		excessively forward
subside		stubbornly resistant to authority or control
viscous		fill to satisfaction
prevaricate		sink to a lower level or form a depression
recant		having a relatively high resistance to flow
saturate		be deliberately ambiguous or unclear
substantiate		formally reject or disavow a formerly held belief
vituperative		infuse or fill completely
pristine		establish or strengthen as with new evidence or facts
recluse		marked by harshly abusive criticism
savor		immaculately clean and unused
supersede		one who lives in solitude
volatile		the taste experience when a savoury condiment is tasted
probity		take the place or move into the position of
recondite		liable to lead to sudden change or violence
secrete		complete and confirmed integrity
supposition		difficult to penetrate
unwarranted		generate and separate from cells or bodily fluids
problematic		the cognitive process of conjecturing
refractory		incapable of being justified or explained
shard		making great mental demands
tacit		stubbornly resistant to authority or control
wary		a broken piece of a brittle artifact
prodigal		implied by or inferred from actions or statements
refute		marked by keen caution and watchful prudence
skeptic		recklessly wasteful
tangential		overthrow by argument, evidence, or proof
welter		someone who habitually doubts accepted beliefs
profound		of superficial relevance if any
relegate		a confused multitude of things
solicitous		situated at or extending to great depth
tenuous		assign to a lower position
whimsical		full of anxiety and concern
prohibitive		very thin in gauge or diameter
reproach		determined by chance or impulse rather than by necessity
soporific		tending to discourage, especially of prices
tirade		express criticism towards
zealot		sleep inducing
proliferate		a speech of violent denunciation
reprobate		a fervent and even militant proponent of something
specious		grow rapidly
torpor		a person without moral scruples
propensity		plausible but false
repudiate		a state of motor and mental inactivity
spectrum		a natural inclination
tortuous		refuse to acknowledge, ratify, or recognize as valid
	a broad range of related objects or values or qualities
	marked by repeated turns and bends
